ENSG00000003987
ENSG00000005513
ENSG00000007402
ENSG00000058404
ENSG00000072274
ENSG00000074047
ENSG00000078898
ENSG00000082293
ENSG00000086159
ENSG00000096088
ENSG00000099937
ENSG00000100053
ENSG00000102003
ENSG00000102287
ENSG00000102837
ENSG00000105143
ENSG00000105467
ENSG00000106804
ENSG00000107147
ENSG00000108176
ENSG00000109101
ENSG00000110680
ENSG00000110975
ENSG00000111087
ENSG00000111262
ENSG00000115194
ENSG00000119457
ENSG00000122012
ENSG00000122136
ENSG00000122711
ENSG00000124092
ENSG00000124701
ENSG00000132437
ENSG00000132874
ENSG00000133116
ENSG00000134443
ENSG00000136574
ENSG00000137441
ENSG00000138152
ENSG00000138944
ENSG00000139352
ENSG00000140022
ENSG00000140470
ENSG00000141096
ENSG00000141750
ENSG00000151655
ENSG00000152822
ENSG00000153253
ENSG00000154493
ENSG00000154645
ENSG00000155011
ENSG00000155897
ENSG00000156009
ENSG00000156140
ENSG00000160180
ENSG00000162399
ENSG00000162779
ENSG00000163554
ENSG00000163873
ENSG00000166562
ENSG00000167619
ENSG00000169347
ENSG00000170091
ENSG00000170835
ENSG00000171303
ENSG00000171431
ENSG00000171435
ENSG00000171551
ENSG00000171564
ENSG00000171658
ENSG00000172000
ENSG00000172717
ENSG00000172867
ENSG00000173157
ENSG00000173805
ENSG00000174226
ENSG00000175426
ENSG00000175445
ENSG00000177398
ENSG00000178343
ENSG00000178372
ENSG00000182175
ENSG00000182545
ENSG00000183166
ENSG00000183607
ENSG00000183715
ENSG00000184502
ENSG00000185860
ENSG00000185985
ENSG00000187323
ENSG00000188488
ENSG00000188508
ENSG00000196091
ENSG00000196132
ENSG00000196169
ENSG00000196549
ENSG00000197953
ENSG00000198574
ENSG00000198756
ENSG00000204296
ENSG00000211650
ENSG00000213366
ENSG00000214514
ENSG00000215009
ENSG00000215853
ENSG00000225465
ENSG00000225530
ENSG00000229233
ENSG00000231625
ENSG00000232053
ENSG00000232774
ENSG00000234854
ENSG00000237863
ENSG00000238755
ENSG00000242512
ENSG00000243236
ENSG00000248079
ENSG00000249628
ENSG00000253301
ENSG00000254054
ENSG00000258018
ENSG00000258732
ENSG00000258806
ENSG00000261409
ENSG00000261452
ENSG00000266968
ENSG00000267056
ENSG00000270640
ENSG00000271778
ENSG00000271996
