ENSG00000021852
ENSG00000056291
ENSG00000072080
ENSG00000082293
ENSG00000096088
ENSG00000101470
ENSG00000102387
ENSG00000104537
ENSG00000105641
ENSG00000108551
ENSG00000108576
ENSG00000109205
ENSG00000110680
ENSG00000122012
ENSG00000123999
ENSG00000125780
ENSG00000129437
ENSG00000132874
ENSG00000132911
ENSG00000134240
ENSG00000134962
ENSG00000139915
ENSG00000141096
ENSG00000141750
ENSG00000144339
ENSG00000145681
ENSG00000146678
ENSG00000148677
ENSG00000150551
ENSG00000152049
ENSG00000153253
ENSG00000156009
ENSG00000156076
ENSG00000158014
ENSG00000160180
ENSG00000162722
ENSG00000165731
ENSG00000165899
ENSG00000169427
ENSG00000169507
ENSG00000170477
ENSG00000170509
ENSG00000171246
ENSG00000174876
ENSG00000176204
ENSG00000179914
ENSG00000180537
ENSG00000183036
ENSG00000185985
ENSG00000187689
ENSG00000188487
ENSG00000188488
ENSG00000188676
ENSG00000196091
ENSG00000196549
ENSG00000198099
ENSG00000204889
ENSG00000205835
ENSG00000223756
ENSG00000230894
ENSG00000232774
ENSG00000234854
ENSG00000235385
ENSG00000238755
ENSG00000240834
ENSG00000249267
ENSG00000250420
ENSG00000254054
ENSG00000254615
ENSG00000257883
ENSG00000258168
ENSG00000266968
